4 13 31
###############################
#p    * **    *   2   1       #
# # # #*# # # # # # # # # # # #
#      ** * *  *   * ** 2 *   #
# # # # # #*# # # # # # #*# # #
#*   * *    *b* *   **        #
# # # # # # # # # # # # # #*# #
#    *     *        *    **  1#
# #*# # #*#*#*#*# # #1# # #*# #
#        * 1 *2*    *   *     #
#*# # # # # # # # # # #*# # #*#
#x*    * **    ** ***     1   #
###############################